####################
#                  #
#     @       #    #
#             #    #
#             #    #
#        #    #    #
#        #         #
#        #     @   #
#@                 #
####################